=====================================|1111111111111111111111111111111111111111111111111111111111111111111111111|######################################
#####################################|                                                                         |######################################
#####################################|                                                                         |######################################
#####       ############       ######|                                                                         |######################################
#####       ############       ######|                                                                         |######################################
#####       ############       ######|                                                                         |######################################
#####################################|                                                                         |######################################
#####################################|                                                                         |######################################
#####################################|                                                                         |######################################
#####################################|                                                                         |######################################
#####       ############       ######|                                                                         |######################################
#####       ############       ######|                                                                         |######################################
#####       ############       ######|                                                                         |######################################
#####################################|                                                                         |######################################
#####################################|                                                                         |######################################
#####################################|                                                                         |######################################
#####################################|                                                                         |######################################
#####################################|                                                                         |######################################
#####################################|                                                                         |######################################
#####################################|                                                                         |######################################
#####################################|                                                                         |######################################
#####################################|                                                                         |######################################
#####################################|                                                                         |######################################
#####################################|                                                                         |######################################
#####################################|                                                                         |######################################
#####################################|                                                                         |######################################
=====================================|                                                                         |######################################
#####################################|                                                                         |######################################
#####################################|                                                                         |######################################
#####################################|                                                                         |######################################
#####################################|                                                                         |######################################
#####       #############       #####|                                                                         |######################################
#####       #############       #####|                                                                         |######################################
#####       #############       #####|                                                                         |######################################
#####################################|                                                                         |######################################
#####################################|                                                                         |######################################
#####################################|                                                                         |######################################
#####################################|                                                                         |######################################
#####################################|                                                                         |######################################
#####       #############       #####|                                                                         |######################################
#####       #############       #####|                                                                         |######################################
#####       #############       #####|                                                                         |######################################
#####################################|                                                                         |######################################
#####################################|                                                                         |######################################
#####################################|                                                                         |######################################
#####################################|                                                                         |######################################
#####################################|                                                                         |######################################
#####################################|                                                                         |######################################
#####################################|                                                                         |######################################
#####################################|                                                                         |######################################
#####################################|                                                                         |######################################
#####################################|                                                                         |######################################
#####################################|                                                                         |######################################
#####################################|                                                                         |######################################
#####################################|                                                                         |######################################
#####################################|2222222222222222222222222222222222222222222222222222222222222222222222222|######################################