=====================================|1111111111111111111111111111111111111111111111111111111111111111111111111|######################################
#####################################|                                                                         |######################################
#####################################|                                                                         |######################################
#####       ############       ######|                                                                         |######################################
#####       ############       ######|                                                                         |######################################
#####       ############       ######|                                                                         |######################################
#####################################|                                                                         |######################################
#####################################|                                                                         |######################################
#####################################|                                                                         |######################################
#####################################|                                                                         |######################################
#####       ############       ######|                                                                         |######################################
#####       ############       ######|                                                                         |######################################
#####       ############       ######|                                                                         |######################################
#####################################|                                                                         |######################################
#####################################|                                                                         |######################################
#####################################|                                                                         |######################################
#####################################|                                                                         |######################################
#####################################|                                                                         |######################################
#####################################|                                                                         |######################################
#####################################|                                                                         |######################################
#####################################|                                                                         |######################################
#####################################|                                                                         |######################################
#####################################|                                                                         |######################################
#####################################|                                                                         |######################################
#####################################|                                                                         |######################################
#####################################|                                                                         |######################################
=====================================|                                                                         |######################################
#####################################|                                                                         |######################################
#####################################|                                                                         |######################################
#####################################|                                                                         |######################################
#####################################|                                                                         |######################################
#####       #############       #####|                                                                         |######################################
#####       #############       #####|                                                                         |######################################
#####       #############       #####|                                                                         |######################################
#####################################|                                                                         |######################################
#####################################|                                                                         |######################################
#####################################|                                                                         |######################################
#####################################|                                                                         |######################################
#####################################|                                                                         |######################################
#####       #############       #####|                                                                         |######################################
#####       #############       #####|                                                                         |######################################
#####       #############       #####|                                                                         |######################################
#####################################|                                                                         |######################################
#####################################|                                                                         |######################################
#####################################|                                                                         |######################################
#####################################|                                                                         |######################################
#####################################|                                                                         |######################################
#####################################|                                                                         |######################################
#####################################|                                                                         |######################################
#####################################|                                                                         |######################################
#####################################|                                                                         |######################################
#####################################|                                                                         |######################################
_____________________________________|                                                                         |______________________________________
X                                                                                                                                                    2
X                                                                                                                                                    2
XXXXXXXXXXXXXXXXXXXXXXXXXXXXXXXXXXXXXXXXXXXXXXXXXXXXXXXXXXXXXXXXXXXXXXXXXXXXXXXXXXXXXXXXXXXXXXXXXXXXXXXXXXXXXXXXXXXXXXXXXXXXXXXXXXXXXXXXXXXXXXXXXXXXXX